 ####
##  #     
#   ###
#   $ #
# #.  #
#   ###
#####     
    