     ###
###### ##
#    .  #
#   #   #
#####$# #
    #   #
#########