#####################
#                   #
#                   #
#  $                #
#       .           #
#                   #
#                   #
#                   #
#                   #
#                   #
#####################