    #####
  #  $ $ #
  #  .#. ##
  ###$.$  #
    #     ###
    #####