#####
#.  ###
# # $ #
#   # #
# .   #
##$ ###
 #  #
 ####