#########
        #
### $ # #
#  . .  #
#   $ ###
#   ###
#####