#####################
#                   #
#                   #
#  $                #
#       .           #
#                   #
#                   #
#                   #
#             $     #
#     .             #
#####################