#####################
#           .       #
#                   #
#  $  #        #    #
#      # .          #
#       #           #
#                   #
#          $        #
#                   #
#                   #
#####################