######
     #   
###  #
#  $$##  
# . . #
###   #
  #####   
    