####################
#                  #
# . .              #
# $ $              # 
#   @              #
#                  #
#                  #
#                  #
#                  #
#                  #
#                  #
#                  #
#                  #
#                  #
####################
