########
#      #
# . .  #
# $$   #
#   $$ #
#  @   #
########
