#######
#     #
# . $ #
# $ @ #
#     #
#######
