#########
#       #
#  . .  #
# $$ $$ #
#   @   #
#       #
#########
